BBBBBBBBBBBBBBBBBBBBBBBBBBB
Bo...B.......B.......B...oB
B.BB...BBBBB.B.BBBBB...BB.B
B.BB.B....BB.B.BB....B.BB.B
 ....B.BB....B....BB.B....
BBB.BB.BB.BBBBBBB.BB.BB.BBB
BBB.....................BBB
BBB.BBBBBBBBB.BBBBBBBBB.BBB
B.......B....P....B.......B
B.BBBBB.B.BBwwwBB.B.BBBBB.B
B...BBB.B.B MMM B.B.BBB...B
B.B.......BB M BB.......B.B
B.BBBB.BB...BBB...BB.BBBB.B
Bo.....BBBB.....BBBB.....oB
BBBBBBBBBBBBBBBBBBBBBBBBBBB