BBBBBBBBBBBBBBBBBBBBBBBBBBB
Bo.......................oB
BBBB.BBB.B.BBB.BBB.BBB.B.BB
BB...B B.B..B..B...B...B.BB
BBBB.BBB.B..B..BBB.B...BBBB
BB...B...B..B..B...B...B.BB
BBBB.B...B..B..BBB.BBB.B.BB
 .........................
B.BBBBBBB....P....BBBBBBB.B
B....B....BBwwwBB....B....B
B.BB.B.BB.B MMM B.BB.B.BB.B
B.BB.B.BB.BB M BB.BB.B.BB.B
B.BB...BB...BBB...BB...BB.B
Bo...B....B.....B....B...oB
BBBBBBBBBBBBBBBBBBBBBBBBBBB
