BBBBBBBBBBBBBBBBBBBBBBBBBBB
Bo...........B...........oB
B.BBBBB.BBBB.B.BBBB.BBBBB.B
B....BB.BBBB.B.BBBB.BB....B
B.BB...................BB.B
B.BB.BB.B.BBBBBBB.B.BB.BB.B
B.BB....B....B....B....BB.B
B....BB.BBBB.B.BBBB.BB....B
BBBB.BB.B....P....B.BB.BBBB
BBBB.BB.B.BB   BB.B.BB.BBBB
 .........B MMM B.........
B.BBBBB.B.B  M  B.B.BBBBB.B
B.BB....B.BBBBBBB.B....BB.B
Bo...BBBB.........BBBB...oB
BBBBBBBBBBBBBBBBBBBBBBBBBBB

